0010000000000100
0010000000000100
1110000000000111
0000011111100000
0000010000100000
0000010000100000
0000010000100000
0000010000100000
0000011111100000
0000000000000000
0000000000000000
0000000000000000